{
    "1": {
        "floor": [
            "1111111111111111111111111111111111111111",
            "1000000000000000000000000000000000000001",
            "1000000000000000000000000000000000000001",
            "1000000011100000000000000000000000000001",
            "1000000011100000000000000000000000000001",
            "1000000000000000000000000000000000000001",
            "1000000000000000000000000000000000000001",
            "1000000000000000000000000000000000000001",
            "1000000000000000000000000000000000000001",
            "1000000000000000000000000000000000000001",
            "1000000000000000000000000000000000000001",
            "1000000000000000000000000000000000000001",
            "1000000000000000000000000000000000000001",
            "1000000000000000000000000000000000000001",
            "1000000000000000000000000000000000000001",
            "1000000000000000000000000000000000000001",
            "1000000000000000000000000000000000000001",
            "1000000000000000000000000000000000000001",
            "1000000000000000000000000000000000000001",
            "1000000000000000000000000000000000000001",
            "1000000000000000000000000000000000000001",
            "1111111111111111111111111111111111111111"
        ],
        "waves": []
    },
    "2": {},
    "3": {},
    "4": {}
}